#######################
###XX#############XX###
#######################
#######################
#######################
#######X########X######
#######X###S####X######
#######X########X######
#######################
#######################
#######################
###XX#############XX###
#######################