XXX#################XXX
XXX#################XXX
#######################
#########XXXXX#########
#######################
#######################
###########S###########
#######################
#######################
#########XXXXX#########
#######################
XXX#################XXX
XXX#################XXX