#######################
#######################
#######################
#######################
########XXXXXXX########
########X#####X########
######S#X#####X#S######
########X#####X########
########XXXXXXX########
#######################
#######################
#######################
#######################