#######################
#######################
#######################
########XXXXXXX######
########XX#############
########XX#############
####S###XXXXXXX###S####
#############XX########
#############XX########
########XXXXXXX########
#######################
#######################
#######################