S#####################S
#######################
#######################
#######XXXXXXXXX#######
#######XXXXXXXXX#######
###########X###########
###########X###########
###########X###########
###########X###########
###########X###########
#######################
#######################
S#####################S