#######################
#######################
#######################
######XXXXXXXXXXX######
###########S###########
#######################
######S#########S######
#######################
###########S###########
######XXXXXXXXXXX######
#######################
#######################
#######################