#####X###########X#####
#####X###########X#####
#####X###########X#####
XXXXXX###########XXXXXX
#######################
#######################
#####S###########S#####
#######################
#######################
XXXXXX###########XXXXXX
#####X###########X#####
#####X###########X#####
#####X###########X#####