#######################
#######################
###XXX###########XXX###
###XXX#####S#####XXX###
#######################
#######################
#######################
#######################
#######################
###XXX#####S#####XXX###
###XXX###########XXX###
#######################
#######################