#######XX#####XX#######
#######################
####XX###########XX####
#######################
X#######S#####S#######X
###########X###########
##########XXX##########
###########X###########
X##########S##########X
#######################
####XX###########XX####
#######################
#######XX#####XX#######