#######################
#######################
##########XXX##########
####S#####XXX#####S####
#######################
#######################
#######################
#######################
#######################
###XXX#####S#####XXX###
###XXX###########XXX###
#######################
#######################